10
1 1 1 1 1 1 1 1 1 1
1 S 0 0 0 0 0 0 0 1
1 0 1 0 1 1 1 1 0 1
1 0 1 0 1 0 0 1 gem1_100_2 1
1 0 0 0 1 0 0 1 1 1
1 0 1 0 0 gem1_10_1 0 0 0 1
1 0 1 0 1 1 1 0 0 1
1 0 1 0 1 0 1 gem2_0-50-1-100_0-1-2 1 1
1 1 1 0 0 0 0 0 2 1
1 1 1 1 1 1 1 1 1 1

11
1 1 1 1 1 1 1 1 1 1 1
1 S 0 0 0 0 0 0 0 0 1
1 0 1 0 1 1 1 1 0 3 1
1 0 1 0 1 0 0 1 0 0 1
1 0 0 0 1 0 0 1 1 gem2_0-1-10-100_0-1-2 1
1 0 1 0 0 0 0 0 0 1 1
1 0 1 0 1 1 1 1 0 1 1
1 0 1 0 1 0 1 1 1 1 1
1 1 1 0 0 0 0 0 0 0 1
1 gem1_27_1 0 0 0 0 0 0 2 0 1
1 1 1 1 1 1 1 1 1 1 1

10
1 1 1 1 1 1 1 1 1 1
1 S 0 0 0 0 0 0 0 1
1 0 1 0 1 1 1 1 0 1
1 0 1 0 1 0 3 1 0 1
1 0 0 0 1 0 0 1 1 1
1 0 1 0 0 0 0 0 0 1
1 0 1 0 1 1 1 1 0 1
1 0 1 0 1 0 1 1 1 1
1 1 1 0 gem1_5_1 0 0 0 2 1
1 1 1 1 1 1 1 1 1 1